NO ./path_to_the_north_texture
SO ./path_to_the_south_texture
WE ./path_to_the_west_texture
EA ./path_to_the_east_texture

F 220,100,0
C 200,225,3

1111111111111       111111111
1 10W11111111       111111111
1111111111111       111111111
