111111111
100000001
100000001
101100001
1000S0001
100000001
100010001
100001001
111111111