111111111
100000001
100000001
100000001
100000001
100000001
100000001
1000S0001
111111111